101111111111111111111111111111111111111111111111111
100000000000000000000000000000000000000000000000001
100000111111100000111111000000001011001111101110001
111000000000100000000001000111111001001000000000001
101000000000100000000001000000001001001000001001001
101000111111100000111111000111001000001000001001001
101000000000001100000000000001001000001000001001001
101000000000001001111110110101001001001001001001001
101000111111101000000010010101001001001001000001001
100000000000101000000010010101001001001001000001001
101110000000101001111110010101001001001001000001001
100000111111100000000000010101001001001001001001001
101000000000000001111111000100001001001001001001001
101011111111111001000000000111111001001001001001001
100000001000000000000000000000001001001001001001001
100001001011111110001111011110000001001001001001001
100111001000000000000001010000000001001001011001001
100000001111111111100101010011000101000001000001111
100000000000000000000101010010000101000001001100001
101001000111111111100101010010000101000001001001001
101001000000000000100100000000000100000000001001001
100001111111111000100111111100000111110001111111001
100000000000000000000000000000000000000000000000001
111011111111111111111111111111111111111111111111111
